#########
#,,,W,,,#
#,,,W,,,#
#,,,W,,,#
#,,,W,,,#
#########

'''''''''
'''''''G'
'''''''G'
'1'''''''
'2'''''''
'''''''''
